objgAnnul=Annuler
objgValid=Ok
objgDim=Dim XY : 
objgBordure=Bordure
objgColor= Couleur : 
objgOpacity=Opacité : 
objgBkg=Arrière-plan : 
objgTranspa=Transparence : 
objgBkgOpacity=Bkg Opacité : 
objgCadre=Cadre
objgWidth=Width : 
objgHeight= Hauteur : 
objgBorderG=Gauche
objgBorderH=Haut
objgBorderD=Droit
objgBorderB=Bas
objgBorderE=Épaisseur
objgBorderR=Radius
objgBorderM=Marge
objgBorderT=Type
objgPb=Pas de bordure
objgPoint=Pointillés
objgTir=Tirets
objgPlein=Pleine
objgDouble=Double
objpMute=Mute :
objpAudio=Audio :
objpFile=Fichier : 
objpDuree=Durée : 
objpCanaux=Canaux : 
objDreel=Durée résultante
objpEnv=Enveloppe
objpGain= Gain :
objpTpEnv= Type d'enveloppe
objpTpEnv1=Linéaire
objpTpEnv2=Exponentielle
objpTpEnv3=Quadratique
objpRate=Vitesse de lecture : 
objpPos=Position : 
objDetune=Detune : 
objLimites=Limites : 
objpNom=Nom : 
objpInstrument=Instrument : 
