cfGeneral=Projekt
cfSpat=Spatialisierung
cfInterf=Schnittstelle
cfNomProjet=Name des Projekts
cfDebut=Datum des Beginns
cfFin=Enddatum
cfComment=Kommentar
cfDossier=Ordner des Projekts
cfDossierAudio=Audio-Ordner
cfDossierImages=Bilder-Ordner
cfGreffon3D=Plug-in spat3D
cfInterv=Intervall
cfReglette=Regeln
cfBrInfos=Infoleiste
cfWorkspace=Arbeitsbereich
cfRegle=Regel
cfMesure=Messung
cfGrille=Raster
cfLargeur=Fenster Breite
cfHauteur=Höhe
cfZoom=Zoom
cfPalette=Palette
cfBkg=Hintergrund :
cfTPolice=Schriftgröße :
cfCPolice=Schriftfarbe:
cfSep=Trennzeichen :
cfCGrille=Grid-Farbe :
cfOGrille=Rasterweite :
cfCSuiveur=Farbe des Verfolgers :
cfBkgActif=Aktiver Hintergrund :
cfOnglet=Popup-Registerkarte
cfAnnul=Abbrechen
cfValid=Validieren
cfQuit=Beenden
cfDefaut=Standard
cfSave=Speichern
cfSvg=SVG
cfLang=Sprache : 
cfPopup=Popup
cfPopBkgT=Hintergrund Titel
cfPopCT=Farbe des Titels
cfPopTT=Schriftgröße Titel
cfPopBkg=Hintergrund Popup
cfPopC=Farbe der Schriftart
cfPopT=Schriftgröße
cfOng=Registerkarte
cfSeconde=Sekunde
