// Ce fichier appartient à l'application Kandiskyscore.
// Ce logiciel est sous license GNU.: GPL-3.0-or-later
// Auteur : D.Blanchemain
// ***************************************************** variables globales **************************
// License
// 
// This Architecture section is free software; you can redistribute it and/or modify it under the terms of the GNU General Public License as published by the Free Software Foundation; either version 3 of the License, or (at your option) any later version.
// 
// This program is distributed in the hope that it will be useful, but WITHOUT ANY WARRANTY; without even the implied warranty of MERCHANTABILITY or FITNESS FOR A PARTICULAR PURPOSE. See the GNU General Public License for more details.
// 
// You should have received a copy of the GNU General Public License along with this program; If not, see http://www.gnu.org/licenses.var contextAudio=new 
Parpeges=Arpeggien und Glissando
Particul=Artikulationen
Pinscript=Inschriften
Plignes=Linien
Pnuances=Nuancen
Psymboles=Symbole
Pfunc=Funktion
Icompt=Zähler
Itempo=Time
Isign=Sign
Iworkspace=Arbeitsbereich 
Icontext=Kontext
Rdeb=Anfang
Rfin=Ende
Variation=Zeitliche Abweichung
VHaut=Übersetzung
Aleat=Zufällig
listFx=Listen-FX
SettingFx=Einstellungen
listFileAudio=Audioliste
listeObjet=Objekt
