objgAnnul=Annuler
objgValid=Ok
objgDim=Dim XY : 
objgRot=Drehen : 
objgBordure=Bordüre : 
objgColor= Farbe : 
objgOpacity=Deckkraft : 
objgBkg=Hintergrund : 
objgTranspa=Transparenz : 
objgBkgOpacity=Bkg-Deckkraft : 
objgCadre=Rand
objgWidth=Breite: : 
objgHeight= Höhe : 
objgBorderG=Links
objgBorderH=Oben
objgBorderD=Rechts
objgBorderB=Unten
objgBorderE=Dicke
objgBorderR=Radius
objgBorderM=Ränder
objgBorderT=Typ
objgPb=Kein Rand
objgPoint=Gepunktet
objgTir=Striche
objgPlein=Voll
objgDouble=Doppelt
objpMute=Stumm :
objpAudio=Audio :
objpFile=Datei : 
objpDuree=Dauer : 
objpCanaux=Kanäle : 
objDreel=Resultierende Dauer
objpEnv=Umschlag
objpGain= Gewinn :
objpTpEnv= Umschlagtyp
objpTpEnv1=Linear
objpTpEnv2=Exponentiell
objpTpEnv3=Quadratisch
objpRate=Lesegeschwindigkeit : 
objpPos=Position : 
objDetune=Verstimmung : 
objLimites=Grenzwerte : 
objpNom=Name : 
objpInstrument=Instrument : 
