cfGeneral=Project
cfSpat=Spatialization
cfInterf=Interface
cfNomProjet=Project name
cfDebut=Start date
cfFin=End date
cfComment=Comment
cfDossier=Project folder
cfDossierAudio=udio folder
cfDossierImages=mages folder
cfGreffon3D=Plug-in spat3D
cfInterv=Interval
cfReglette=Reglettes
cfBrInfos=Info bar
cfWorkspace=Workspace
cfRegle=Regle
cfMesure=Measure
cfGrille=Grid
cfLargeur=Width : 
cfHauteur= Height : 
cfZoom= Zoom : 
cfPalette=Palette
cfBkg=Background :
cfTPolice=Font size :
cfCPolice=Font colour :
cfSep=Separator :
cfCGrille=Grid colour :
cfOGrille=Grid size :
cfCSuiveur=Follower colour :
cfBkgActif=Active background:
cfOnglet=Popup tab
cfAnnul=Cancel
cfValid=Validate
cfQuit=Exit
cfDefaut=Default
cfSave=Save
cfSvg=SVG
cfLang=Language : 
cfPopup=Popup
cfPopBkgT=Title background
cfPopCT=Title colour
cfPopTT=Title font size
cfPopBkg=Popup background
cfPopC=Font colour
cfPopT=Font size
cfOng=Tab
cfSeconde=Second
