objgCancel=Cancel
objgValid=Ok
objgDim=Dim XY : 
objgBorder=Border 
objgColor= Color : 
objgOpacity=Opacity : 
objgBkg=Background : 
objgTranspa=Transparency : 
objgBkgOpacity=Bkg Opacity : 
objgCadre=Border
objgWidth=Width : 
objgHeight= Height : 
objgBorderG=Left
objgBorderH=Top
objgBorderD=Right
objgBorderB=Bottom
objgBorderE=Thickness
objgBorderR=Radius
objgBorderM=Margin
objgBorderT=Type
objgPb=No border
objgPoint=Dotted
objgTir=Dash
objgPlein=Full
objgDouble=Double
objpMute=Mute : 
objpAudio=Audio :
objpFile=File : 
objpDuree=Duration : 
objpCanaux=Channels : 
objDreel=Resulting duration
objpEnv=Envelope
objpGain=Gain : 
objpTpEnv= Envelope type
objpTpEnv1=Linear
objpTpEnv2=Exponential
objpTpEnv3=Quadratic
objpRate=Reading speed : 
objpPos=Position : 
objDetune=Detune : 
objLimites=Limits : 
objpNom=Name : 
objpInstrument=Instrument :  
