cfGeneral=Proyecto
cfSpat=Spatialization
cfInterf=Interfaz
cfNomProjet=Nombre del proyecto
cfDebut=Fecha de inicio
cfFin=Fecha de finalización
cfComment=Comentario
cfDossier=Carpeta del proyecto
cfDossierAudio=Carpeta de audio
cfDossierImages=Carpeta de imágenes
cfGreffon3D=Plug-in spat3D
cfInterv=Intervalo
cfReglette=Regletas
cfBrInfos=Barra de información
cfWorkspace=Espacio de trabajo
cfRegle=Regla
cfMesure=Medida
cfGrille=Cuadrícula
cfLargeur=Ancho ventana
cfHauteur=Altura
cfZoom=Zoom
cfPalette=Paleta
cfBkg=Fondo :
cfTPolice=Tamaño de fuente :
cfCPolice=Color de fuente :
cfSep=Separador :
cfCGrille=Color de la cuadrícula :
cfOGrille=Tamaño de la cuadrícula :
cfCSuiveur=Color del seguidor :
cfBkgActif=Fondo activo:
cfOnglet=Pestaña desplegable
cfAnnul=Cancelar
cfValid=Validar
cfQuit=Salir
cfDefaut=Por defecto
cfSave=Guardar
cfSvg=SVG
cfLang=Idioma : 
cfPopup=Popup
cfPopBkgT==Fondo del título
cfPopCT=Color del título
cfPopTT=Tamaño de fuente del título
cfPopBkg=Fondo de popup
cfPopC=Color de fuente
cfPopT=Tamaño de fuente
cfOng=Tabulador
cfSeconde=Segundo
