// Ce fichier appartient à l'application Kandiskyscore.
// Ce logiciel est sous license GNU.: GPL-3.0-or-later
// Auteur : D.Blanchemain
// ***************************************************** variables globales **************************
// License
// 
// This Architecture section is free software; you can redistribute it and/or modify it under the terms of the GNU General Public License as published by the Free Software Foundation; either version 3 of the License, or (at your option) any later version.
// 
// This program is distributed in the hope that it will be useful, but WITHOUT ANY WARRANTY; without even the implied warranty of MERCHANTABILITY or FITNESS FOR A PARTICULAR PURPOSE. See the GNU General Public License for more details.
// 
// You should have received a copy of the GNU General Public License along with this program; If not, see http://www.gnu.org/licenses.var
Parpeges=Arpegios y glissando
Particul=Articulaciones
Pinscript=Inscripciones
Plignes=Líneas
Pnuances=Nuances
Psymboles=Símbolos
Pfunc=Funciones
Icompt=Contador
Itempo=Tempo
Isign=Sign.
Iworkspace=Espacio de trabajo  
Icontext=Contexto
Rdeb=Inicio
Rfin=Fin
Variation=Variación temporal
VHaut=Transposición
Aleat=Aleatorio
listFx=Listar efectos
SettingFx=Configuración
listFileAudio=Lista de audios
listeObjet=objeto
