objgAnnul=Cancelar
objgValid=validar
objgDim=Dim XY : 
objgDimX=Dim X : 
objgDimY=Dim Y : 
objgRot=Rotación : 
objgBordure=Borde : 
objgColor= Color : 
objgOpacity=Opacidad : 
objgBkg=Fondo : 
objgTranspa=Transparencia : 
objgBkgOpacity=Opacidad del fondo : 
objgCadre=Marco
objgWidth=Ancho : 
objgHeight= Altura : 
objgBorderG=Izquierda
objgBorderH=Arriba
objgBorderD=Derecha
objgBorderB=Abajo
objgBorderE=Espesor
objgBorderR=Rayos
objgBorderM=Margen
objgBorderT=Tipo
objgPb=Sin borde
objgPoint=Punteado
objgTir=Guiones
objgPlein=Completo
objgDouble=Doble
objpMute=Silenciar :
objpAudio=Audio :
objpFile=Archivo : 
objpDuree=Duración : 
objpCanaux=Canales : 
objDreel=Duración resultante
objpEnv=Sobre
objpGain= Ganancia :
objpTpEnv= Tipo de sobre
objpTpEnv1=Lineal
objpTpEnv2=Exponencial
objpTpEnv3=Cuadrático
objpRate=Velocidad de lectura : 
objpPos=Posición : 
objDetune=Desafinar : 
objLimites=Limites : 
objpNom=Nombre : 
objpInstrument=Instrumento :  
