cfGeneral=Progetto
cfSpat=Spazializzazione
cfInterf=Interfaccia
cfNomProjet=Nome del progetto
cfDebut=Data di inizio
cfFin=Data di fine
cfComment=Commento
cfDossier=Cartella del progetto
cfDossierAudio=Cartella audio
cfDossierImages=Cartella immagini
cfGreffon3D=Plug-in spat3D
cfInterv=Intervalo
cfReglette=Regletas
cfBrInfos=Barra delle informazioni
cfWorkspace=Spazio di lavoro
cfRegle=Regola
cfMesure=Misura
cfGrille=Griglia
cfLargeur=Larghezza finestra : 
cfHauteur= Altezza : 
cfZoom= Zoom : 
cfPalette=Paleta
cfBkg=Sfondo :
cfTPolice=Dimensione carattere :
cfCPolice=Colore del carattere :
cfSep=Separatore :
cfCGrille=Colore griglia :
cfOGrille=Dimensione griglia :
cfCSuiveur=Colore seguace :
cfBkgActif=Sfondo attivo:
cfOnglet=Tabella popup
cfAnnul=Annulla
cfValid=Valida
cfQuit=Esci
cfDefaut=Por defecto
cfSave=Salva
cfSvg=SVG
cfLang=Lingua :  
cfPopup=Popup
cfPopBkgT=Sfondo del titolo
cfPopCT=Colore del titolo
cfPopTT=Dimensione carattere del titolo
cfPopBkg=Sfondo del popup
cfPopC=Colore carattere
cfPopT=Dimensione carattere
cfOng=Tab
cfSeconde=Secondo
