// Ce fichier appartient Ã  l'application Kandiskyscore.
// Ce logiciel est sous license GNU.: GPL-3.0-or-later
// Auteur : D.Blanchemain
// ***************************************************** variables globales **************************
// License
// 
// This Architecture section is free software; you can redistribute it and/or modify it under the terms of the GNU General Public License as published by the Free Software Foundation; either version 3 of the License, or (at your option) any later version.
// 
// This program is distributed in the hope that it will be useful, but WITHOUT ANY WARRANTY; without even the implied warranty of MERCHANTABILITY or FITNESS FOR A PARTICULAR PURPOSE. See the GNU General Public License for more details.
// 
// You should have received a copy of the GNU General Public License along with this program; If not, see http://www.gnu.org/licenses.var contextAudio=new 
Parpeges=Arpeggi e Glissandi
Particul=Giunti
Pinscript=Iscrizioni
Plignes=Linee
Pnuances=Sfumature
Psymboles=Simboli
Pfunc=Funzioni
Icompt=Contatore
Itempo=Tempo
Isign=Segno
Iworkspace=Area di lavoro
Icontext=Contesto
Rdeb=Inizio
Rfin=Fine
Variation=Variazione lineare
VHaut=Trasposizione
Aleat=Casuale
listFx=Elenca effetti
SettingFx=Impostazioni
listFileAudio=Elenco audio
listeObjet=Oggetto
