objgAnnul=Annulla
objgValid=Ok
objgDim=Dim XY : 
objgDimX=Dim X : 
objgDimY=Dim Y : 
objgRot=Ruota
objgBordure=Bordo : 
objgColor= Colore : 
objgOpacity=Opacità : 
objgBkg=Sfondo : 
objgTranspa=Trasparenza : 
objgBkgOpacity=Bkg Opacità : 
objgCadre=Cornice
objgWidth=Larghezza : 
objgHeight= Altezza : 
objgBorderG=Sinistra
objgBorderH=In alto
objgBorderD=Destra
objgBorderB=In basso
objgBorderE=Spessore
objgBorderR=Raggio
objgBorderM=Margine
objgBorderT=Tipo
objgPb=Nessun bordo
objgPoint=Punteggiato
objgTir=Trattini
objgPlein=Pieno
objgDouble=Doppio
objpMute=Muto :
objpAudio=Audio :
objpFile=File : 
objpDuree=Durata : 
objpCanaux=Canali : 
objDreel=Durata risultante
objpEnv=Busta
objpGain= Guadagno :
objpTpEnv= Tipo di busta
objpTpEnv1=Lineare
objpTpEnv2=Esponenziale
objpTpEnv3=Quadratico
objpRate=Velocità di lettura : 
objpPos=Posizione : 
objDetune=Stona : 
objLimites=Limiti : 
objpNom=Nome: 
objpInstrument=Strumento : 
